R 1000 1000
NO ./stone.xpm
SO ./wood.xpm
WE ./path_to_the_west_texture
EA ./path_to_the_east_texture
S ./path_to_the_sprite_texture
F 220,100,0
C 225,30,0
11111111111111111111111111111
1000000000000000000000001111111111
101100000111000000N0000011111
10010000000000000000000011111
11111111101100000111000000001
10000000001100000111011111111
11110101111111011100000010001
11110101111111011101010010001
11000000110101011100000010001
100020000000000011000000100001
10000000000000001101010010001
11000001110001011001011110001
11110111111100010000111101001
11111111111111111111111111111