R 1000 1000
NO ./redbrick.xpm           
WE ./nazi.xpm                
SO ./wood.xpm                        
EA ./eagle.xpm   
S ./barrel.xpm
F 128,128,122   
C 0,135,206
                                                       11111111111111111111111111111111111111111111111111111
                                                       10000000000000000000000000000000000000000000001111111
      1111111111111111111111111111111111111111         100000000000000000000000000000000000000000000000011111
 111111110000000000000000000000011    11111            100000000000000000000000000000000000000000000111111111
 10000000000000000011110000000000111   11111111111     100000000000000000000000000000000000000000000001111111
 1100000000000000001  10000000000001   11000000001     1000000000000010000010000000000000000000000000001011111111
 1111111111111111111  11111100111111   111111111001    1000000000000000000000000000000000000000000000001111111
                           10001               1011    11000000000000000000000000N00000000000000000000000000011111
 11111111111111111     111110001111111111111   101111  10000000000000000000121212000000000000000000000000001111111
 11000000000000011    11000000000000000000001   100001 10000000000000000000000210000000000000000000000000000111111
 10000000000000001    1000000000000000000001   1100011 100000000000000000000000000000000000000000000000000001111
 11000000000000011    1100000000000111110001   1000001 1000000000000000000000000000000000000000000000000000000111
 100000000000001      1000000000001   10001   1000001 1000000000000000000000000000000000000000000000000000111111
 111000000000000111111110000000001   10001   11000011100000000000000000000000000000000000000000000000000011
1111000000000000001000000000000001   10001  11100000000000000000000000000000000000000000000000000000000011
  1100000000000000000000000001111111  11111111100001111100000000000000000000000000000000000000000000000011
  1111000001100000000000000000001            100001    100000000000000000000000000000000000000000000000011
111000000000000000000000000001111111111111111110001    1000000000000000000000000000000000000000000000001111 
111111000000000000000000000000000000000000000000001    1000000000000000000000000000000000000000000000111  
    11111100000000000000000011111111111111111000001    100000000000000000000000000000000000000000000011
        1111110000000000111111            111111111    10000000000000000000000000000000000000000000011
            11111111001111111111                       1000000000000000000000000000000000000000000011
                  110011                               111111111111111111111111111111111111111111111
                  110111                     11111111111
                  110011                     10000000001
                  110011                     10011110001
                  110011                     10011110001
             111110100001111111111111111111111100111100011111111111111111111111111
             10000000000000000000000000000000000000000000000000000000000011
             10000000000000000000011111111111111111000000000000000000000011
             1111100000000000000001               1000000000000000000000011
                 100000000000000001               1000001111111111111111111
    11111111111111100001111111111111111111111111111000001
    110000000000000000000000000000000000000000000000000011       11111111111111111
    110000000000000000000000000000000000000000000000000011       10000000000000011
    110000000000000000000000000000000000000000000000000011111111110000000000000011
    110000000000000000000002000000000000000000000000000000000000000000002000000011
    11000000000000000000000200000000000000000000000000000000000000000000200000001
    110000000000000000000002000000000000000000000000000011111111110000002000000001
    110000000000000000000000000000000000000000000000000011       1000000200000000111111111
    110000000000000000000000000000000000000000000000000011       1000000000000000002000011
    110000000000000000000000000000000000000000000000000011   11111000000000000000002000001
    110000000000000000000000000000000000000000000000000011   10000000000000000000002000001
    110000000000000000000000000000000000000000000000000011   10000000000000000000002000001
    110000000000000000000000000000000000000000000000000011   11111111111111111111111111111
    1111111111111111111111111111111111111111111111111111
    111111
