R 1000 1000
NO ./stone.xpm
SO ./wood.xpm
WE ./path_to_the_west_texture
EA ./path_to_the_east_texture
S ./path_to_the_sprite_texture
F 220,100,0
C 225,30,0
                                                       11111111111111111111111111111111111111111111111      
                                                       100000000000000000000000000000000000000000000011        
      1111111111111111111111111111111111111111         10000000000000000000000000000000000000000000000011
 111111110000000000000000000000011    11111            10000000000000000000000000000000000000000000000011
 10000000000000000011110000000000111   11111111111     100000000000000000000000000000000000000000000000011
 1100000000000000001  10000000000001   11000000001     10000000000000100000000000000000000000000000000000111
 1111111111111111111  11111110111111   111111111001    100000000000000000000000000200000000000000000000000001
                           10001               101     100000000000000000000000021200000000000000000000000011
 11111111111111111     111110001111111111111   101111  1000000000000000000000002111200000000000000000000000011
 11000000000000011    11000000000000000000001   100001  10000000000000000000000211 11200000000000000000000000011
 10000000000000001    1000000000000000000001   1100011 1000000000000000000000211   11200000000000000000000000011
 11000000000000011    1100000000000111110001   1000001 10000000000000000000000211 112000000000000000000000000101
 100000000000001      1000000000001   10001   1000001 1000000000000000000000002111200000000000000000000000011
 11100000000000011111111000000000001   10001   11000011100000000000000000000000021200000000000000000000000011
  1111000000000000001000000000000001   10001  11100000000000000000000000000000000200000000000000000000000011
  1100000000000000000000000001111111   11111  1000111111000000000000000000000000000000000000000000000000011
  1111000001100000000000000000001            100001    100000000000002000000000000000000000000000000000011
111000000000000000000000000001111111111111111110001    100000000000002000000000000000000000000000000000111    
111111000000000000000000000000000000000000000000001     1000000000000020000000000000000000000000000000011
    11111100000000000000000011111111111111111000001    100000000000002000000000000000000000000000000011
        1111110000000000111111            111111111    10000000000000000000000000000000000000000000011
            11111111001111111111                       1000000000000000000000000000000000000000000011
                  110011                               111111111111111111111111111111111111111111111
                  110011                     11111111111
                  110011                     10000000001
                  110011                     10011110001
                  110011                     1001  10001
             111111100001111111111111111111111100111100011111111111111111111111111
             10000000000000000000000000000000000000000000000000000000000011
             10000000000000000000011111111111111111000000000000000000000011
             1111100000000000000001               1000000000000000000000011
                 100000000000000001               1000000111111111111111111
    111111111111111000011111111111111111111111111110000011
    110000000000000N00000000000000000000000000000000000011       11111111111111111
    110000000000000000000020000000000000000000000000000011       10000000000000001
    110000000000000000000000000000000000000000000000000011111111110000000000000001
    11000000000000000000000000000000000000000000000000000000000000000000000000001
    110000000000000000000000000000000000000000000000000000000000000000000000000001
    110000000000000000000000000000000000000000000000000011111111110000000000000001
    110000000000000000000000000000000000000000000000000011       1000000000000000111111111
    110000000000000000000000000000000000000000000000000011       1000000000000000000000001
    110000000000000000000000000000000000000000000000000011   11111000000000000000000000001
    110000000000000000000000000000000000000000000000000011   10000000000000000000000000001
    110000000000000000000000000000000000000000000000000011   10000000000000000000000000001
    110000000000000000000000000000000000000000000000000011   11111111111111111111111111111
    1111111111111111111111111111111111111111111111111111